1 6 2 1 5 4 5 5 1 1
1 0 0 0 0 0 0 0 0 1
1 0 3 0 7 3 0 3 0 1
1 0 0 0 0 0 0 0 0 1
1 0 3 0 3 3 0 7 0 1
1 0 0 0 0 0 0 0 0 1
1 0 7 0 3 3 0 3 0 1
1 0 0 0 0 0 0 0 0 1
1 0 3 0 7 3 0 7 0 1
1 0 0 0 0 0 0 0 0 1 
1 1 1 1 1 1 1 1 1 1